########...
#.#...@#...
#.#.####...
#.#.#......
#.#.#......
#.#.##.....
#....#.....
####.......
...#.#.....
...#.#.....
...#.#.....