...#.#.....
...#.#.....
...#.#.....
...#.#.....
####.######
....@......
####.######
...#.#.....
...#.#.....
...#.#.....
...#.#.....